TTTTTTTTTTTTTTTTTTTTTTTTTTTTTTT
T       RWWWR          T      T
T R     RWWWR                 T
T       RRRRR                 T
T        TDT                  T
T         DDDDDDDDDDDDDd
T                             T
T          R                  T
TTTTTTTTTTTTTTTTTTTT          T
                   T          T
         R         T          T
                   TTTTTTTTTTTT