TTTTTTTTTTTTTTTTTTTTTTT
TWWWRW                T
TWWWWW                T
TWWWWW                T
TRRRRRddddddddddddddddD
T                     T
T                     T
T                     T
TTTTTTTTTTTTTTTTTTTTTTT